1111111111111111111111111111111111
1E0000000000000C00000C0000000000E1
1111111111111111111111111111111111
