11111111
101C10P1
1E000001
11111111