11111111
1C1C10P1
1EC0C001
11111111