11111111111111111111111
101C11000000P000000C001
1000E000000000000000001
11001C01001010101010C01
1C000000001C00001000001
11111111111111111111111
