11111111111111111111111111111111111
1P1C1100000000000000000000000000001
1000E000000000000000000000000000001
11001C01001010101010000000000000001
1C000000001C00001000000000000000001
11111111111111111111111111111111111
