11111111111111111111111
1000010000110000P000001
10000E00000C00010000001
11000010000N00001000011
11000010000000000100001
11000010000100001000011
100C0100C010C0100C01011
100C0000C011100C0100C01
100C0100C00000C00000001
11111111111111111111111