11111111111111111111111
101C11000000P000000C001
1000E00C000000C00000001
11001001001010101010001
11001001001010100010001
11001001001010101010001
11001001001010101010001
11001001001010101010001
1C0C000C001000001000001
11111111111111111111111