11111111111111111111111
101C11000000P000000C001
1000E00C000000C01010001
11001001001010100010001
11001001001010100010001
11001001001010101010001
11001001001010101010N01
11001011101010101010001
1C0C000C101000001000001
11111111111111111111111