11111111111111111111111
1000010000110000P000001
10000E00000000010000001
11000010000000001000011
110000100C0000000100001
110000100001000C1000011
100001000010011C0001011
10000000001110000100001
10000100000000000000001
11111111111111111111111