11111111
111E11P1
100C1101
10111101
100C0001
11111111