11111111
101C10P1
1E001101
10000C01
100C0001
101C1001
1C000001
11111111