11111111
101C10P1
10E00001
100C1011
11111111