11111111
101C10P1
10E00001
100C10E1
11111111