11111111
100E00P1
100C0001
10000001
100C0001
11111111