11111111
110E10P1
100C0101
11010001
100C0101
11111111