11111111
101C01P1
100E0111
10111001
101C1001
11111111