11111111
101C00P1
100E0001
10111001
101C1001
11111111