1111111111111111111111111111111111111111111111111111111111111111111111111111111111111111111111111111111111111111111111111111111111111
1E0000000000000C00000C000000000000000000000000C00000C000000000001111C00001C00000C000000000000000000000000C00000C000000000001111C00001
1010010100100000101001000000010100000000000000C00000C000000000001111C00000C00000C000000000001000000000000C00000C000000000000000C00001
10100100101010100010010000000101010000000000000C00000C000000000001111C0000C00000C000000000001000000000000C00000C000000000001111C00001
1P0000000C00C0000000000000000000C10000000000000C00000C000000000000000C0001C00000C000000000000100000000000C00000C000000000001111C00001
1111111111111111111111111111111111111111111111111111111111111111111111111111111111111111111111111111111111111111111111111111111111111