111111111111111111111
1P1C1E010000000000011
10000000001110111101
10000000C000C00000101
111111111111111111111