11111111
1CE0d0P1
10000C01
11111111