111111111
1000000C1
10P0N00E1
111111111