11111111
101C1001
1E000001
11111111