1111111111111111111111111111111111
1E0000000000000C00000C000000000001
1010001100100000011001000000010101
1010010100100010001001000000010101
1P0000111C1C00000111000N00000000C1
110000000C00C0000000000000000000C1
1111111111111111111111111111111111