11111111
101C10P1
10000001
11111111