11111111
101010P1
10E00001
11111111