11111111
101C10P0
10E00001
11111111