111110111
101C10P1
10E00001
11111111