11111111
101C10P1
10E000E1
100C1011
11111111