1111111111
1P0C0001E1
1101110001
1101111111
11N1111111
1111111111