case 1: "valid"
------------
11111111
101C10P1
1E000001
11111111
------------

case 2: "invalid x = y"
------------
11111111
101C10P1
1E001101
10000C01
100C0001
101C1001
1C000001
11111111
------------

case 3: "invalid No P"
------------
11111111
101C1001
1E000001
11111111
------------

case 4: "invalid No E"
------------
11111111
101C10P1
10000001
11111111
------------

case 5: "invalid No C"
------------
11111111
101010P1
10E00001
11111111
------------

case 6: "invalid problem in walls"
------------
11111111
101C10P0
10E00001
11111111
------------

case 7: "invalid problem in lenght"
------------
111110111
101C10P1
10E00001
11111111
------------

case 8: "valid"
------------
11111111
101C10P1
10E00001
100C1011
11111111
------------

case 9: "valid"
------------
11111111
101C10P1
10E00001
100C1011
11111111

------------

case 10: "invalid"
------------
11111111
101C10P1
10E00001

100C1011
11111111
------------

case 11: "invalid more than one E"
------------
11111111
101C10P1
10E000E1
100C1011
11111111
------------

case 12: "invalid more than one E"
------------
11111111
101C10P1
10E00001
100C10E1
11111111
------------

case 13: "invalid more than one E and problem in walls"
------------
11111111
101C10P1
10E00001
100C1001
111111E1
------------

case 14: "invalid can't take one C"
------------
11111111
101C00P1
100E0001
10111001
101C1001
11111111
------------

case 15: "invalid no paths"
------------
11111111
101C01P1
100E0111
10111001
101C1001
11111111
------------

case 16: "?"
----------------------------------------------------------------------------------------------------------------------------------------------------
1111111111111111111111111111111111111111111111111111111111111111111111111111111111111111111111111111111111111111111111111111111111111
1E0000000000000C00000C000000000000000000000000C00000C000000000001111C00001C00000C000000000000000000000000C00000C000000000001111C00001
1010010100100000101001000000010100000000000000C00000C000000000001111C00000C00000C000000000001000000000000C00000C000000000000000C00001
10100100101010100010010000000101010000000000000C00000C000000000001111C0000C00000C000000000001000000000000C00000C000000000001111C00001
1P0000000C00C0000000000000000000C10000000000000C00000C000000000000000C0001C00000C000000000000100000000000C00000C000000000001111C00001
1111111111111111111111111111111111111111111111111111111111111111111111111111111111111111111111111111111111111111111111111111111111111
----------------------------------------------------------------------------------------------------------------------------------------------------

case 17: "valid one path"
------------
11111111
111E11P1
100C1101
10111101
100C0001
11111111
------------

case 18: "valid no walls "
------------
11111111
100E00P1
100C0001
10000001
100C0001
11111111
------------

case 19: "valid"
------------
11111111
110E10P1
100C0101
11010001
100C0101
11111111
------------

case 20: "invalid"
------------
11111111
------------

case 21: "invalid"
------------
11111111
11111111
------------

case 22: "valid"
------------
11111111
1CE000P1
11111111
------------

case 23: "invalid"
------------
------------

case 24: "invalid add a char"
------------
11111111
1CE0d0P1
10000C01
11111111
------------